# These were generated by ChatGPT
# https://chat.openai.com/share/9dde9381-dce8-4ba1-b912-3ba6e7493242

pantaloni - pantaloniț
umbra - umbruliț
sticlă - sticliț
dulap - dulăpoiț
lacăt - lacățiț
vin - vișniț
ghiozdan - ghiozdănel
portmoneu - portmoneuliț
lanț - lanțuliț
somn - somnuliț
cioc - ciociuliț
gâscă - găștiț
telecomandă - telecomandiț
blender - blenderiț
gură - guriț
capșună - capșuniț
leu - leuliț
corn - cornuliț
plan - planuliț
farfurie - farfurioară
sandwich - sandwichiț
plăcintă - plăcintuliț
pantalon - pantaloniț
ananas - ananasiț
creion - creionuț
țestoasă - țestoasăț
hârtie - hârtiuliț
ciocan - ciocănel
lumină - luminiț
șofer - șoferiț
frigider - frigideriț
pâine - pâiniț
geam - geamiț
papuc - papuciț
valiză - valișor
balon - baloniț
fluture - fluturaș
clăbuc - clăbuț
ghidon - ghidonaș
șurub - șurubiț
bucătar - bucătăraș
trenulet - trenuleț
câine - cățeluș
pui - puiuț
frunză - frunziț
ceapă - ceapăluț
plapumă - plăpumiț
ghete - ghețuț
creion - creionel
bormașină - bormașiniț
portofel - portofeleț
telefon - telefoaneț
castel - casteleț
covor - covoraș
ciorbă - ciorbiț
cofetar - cofetăraș
ciocănit - ciocăniț
canapea - canapeleț
taburet - taburețiț
umbrelă - umbreleț
clopotei - clopoțeiț
comodă - comoziț
țarcuri - țarcuriț
cuptor - cuptoraș
cremă - cremuliț
platou - plătiț
foarfecă - foarfeciț
luminatoare - luminătoareț
hârtie - hârtiuliț

șotron - șotronez
fleșcăitură - fleșcăiuț
brumă - brumezică
strugure - strugurel
monstru - monstruleț
chiar - chiațiș
ciuf - ciufulică
bocanc - bocănel
castron - castronel
puzzle - puzzulezică
izvor - izvorez
claxon - claxonez
țigară - țigărică
bustean - busteanică
zgâriat - zgârietic
melc - melculeț
fulger - fulgeruț
nord - nordelez
fals - falsez
bucată - bucateză
cravată - cravatez
coșar - coșăric
volan - volanez
cotlet - cotletez
pantof - pantofoz
cauciuc - cauciuzez
vapor - vaporaș
aparat - aparatel
lumânare - lumănărică
buzunar - buzunărică
dulce - dulcezică
soare - soărică
salcie - salcioară
cămila - cămiluș
colț - colțuț
pilot - pilotez
pâine - pâniț
cilindru - cilindriț
clopote - clopotez
fragil - fragilez
pernă - pernuț
catedrală - catedralică
creion - creionez
pijama - pijamez
lup - lupuleț
mănușă - mănușiț
clopote - clopotez
strung - strungez
pânză - pânziț
minte - minteziț
fotograf - fotografică
cabinet - cabinetul
ochelari - ochelariț
cărucior - cărucioriț
fereastră - fereastraș
claviculă - claviculiț
penar - penariț
carte - cărțiț
rulou - rulouriț
ciocan - ciocanez
biscuit - biscuitez
jurnal - jurnaliț
fir - firică
zbor - zboriț
lampă - lampiț
umbrelă - umbreliț
barcă - barciț
ghidon - ghidonez
tricou - tricouliț
orecchie - orecchiuț
jachetă - jachetiț
oracol - oracoliț
gât - gătică
masă - măsuț
tomat - tomatez
saltea - salteziț
cruce - cruciț
televizor - televizoriț
cartof - cartofeziț
copac - copăcel
clopot - clopotiț
bluză - bluziț
imagine - imaginiț
mânz - mânzuț
claviatură - claviaturică
pescar - pescaruț
tren - trenuț
strugure - strugurez
liniște - liniștiț
sticlă - sticlez
genunchi - genunchiuliț
lampă - lampiț
cadru - cadruțiț
geam - geamiț
alb - albiț
pământ - pământuț
radar - radariț
șopârlă - șopărliț
fermecat - fermecațiț
bucurie - bucuriț
teatru - teatriț
foarfecă - foarfecez
telefon - telefonuț
cadou - cadouliț
poveste - poveștiț
fotoliu - fotoliuț
ciocolată - ciocolățică
plăcintă - plăcinteziț
prosop - prosopeț
radiator - radiatoriț
animal - animaliț
castel - casteleziț
berbec - berbecuț
plută - pluteziț
topor - topoareziț
vitrină - vitrineziț
ferigă - ferigeziț
lampion - lampionuț
puf - pufuleziț
căpșună - căpșuneziț
veioză - veiozeziț
grădină - grădineziț
clopoteș - clopoteziț
spic - spiceziț
microundă - microundeziț
cal - căluț
pereche - perechezic
valiză - valizeziț
dulce - dulceziț
girafă - girafeziț
lunar - lunariț
gaz - gazoziț
laptop - laptopiț
ciocan - ciocăniț
colțar - colțareziț
cub - cubuleziț
mure - mureziț
bujor - bujoreziț
aripă - aripeziț
vârf - vârfuț

#: Duplicates 
#: dupe pantaloni - pantaloniț
#: dupe cioc - ciociuliț
#: dupe creion - creionuț [2]
#: dupe clăbuc - clăbuț
#: dupe șurub - șurubiț
#: dupe câine - cățeluș
#: dupe telefon - telefoaneț
#: dupe zâmbet - zâmbetuț [5]
#: dupe lampă - lampăruț [12]
#: dupe bluză - bluziț
#: dupe coș - coșariț [2]
#: dupe tren - trenuț
#: dupe fotoliu - fotoliuț
#: dupe castel - casteleziț
#: dupe berbec - berbecuț
#: dupe plută - pluteziț
#: dupe topor - topoareziț
#: dupe vitrină - vitrineziț
#: dupe ferigă - ferigeziț
#: dupe balaur - balauriț [4]
#: dupe lampion - lampionuț
#: dupe puf - pufuleziț
#: dupe căpșună - căpșuneziț
#: dupe veioză - veiozeziț
#: dupe grădină - grădineziț
#: dupe clopoteș - clopoteziț
#: dupe spic - spiceziț
#: dupe microundă - microundeziț
#: dupe umbrelă - umbreleziț [3]
#: dupe cal - căluț
#: dupe pereche - perechezic
#: dupe valiză - valizeziț
#: dupe steluță - steluțeziț [3]
#: dupe țiglă - țigleziț [2]
#: dupe dulce - dulceziț
#: dupe girafă - girafeziț
#: dupe lunar - lunariț
#: dupe gaz - gazoziț
#: dupe viteză - vitezăriț [2]
#: dupe laptop - laptopiț
#: dupe ciocan - ciocăniț
#: dupe colțar - colțareziț
#: dupe cub - cubuleziț
#: dupe mure - mureziț
#: dupe bujor - bujoreziț
#: dupe aripă - aripeziț
#: dupe vârf - vârfuț